work with a partner => arbeiten Sie mit einem Partner
give me => geben Sie mir
go, walk => gehen Sie
listen => hören Sie zu
go, run => laufen Sie
read => lesen Sie
take => nehmen Sie
open => öffnen Sie
say => sagen Sie
look => schauen Sie
close, shut => schließen Sie
write, spell => schreiben Sie
sit down => setzen Sie sich
jump => springen Sie
get up, stand up => stehen Sie auf
he/she has => er/sie hat
he/she is wearing => er/sie trägt
do you wear? / are you wearing? => trägst du?
a watch => eine Armbanduhr
glasses => eine Brille
pants => eine Hose
a tie => eine Krawatte
a suit => einen Anzug
a coat, an overcoat => einen Mantel
an earring => einen Ohrring
a skirt => einen Rock
a shirt => ein Hemd
a dress => ein Kleid
a sports jacket => ein Sakko
a headband => ein Stirnband
boots => Stiefel
a blouse => eine Bluse
a jacket => eine Jacke
a hat => einen Hut
shoes => Schuhe
sports shoes => Sportschuhe
yellow => gelb
purple => lila
pink => rosa
black => schwarz
blue => blau
brown => braun
grey => grau
green => grün
orange => orange
red => rot
white => weiß
goodbye => auf Wiedersehen
so long / see you soon => bis bald
hi (switzerland) => grüezi
good afternoon / hello (formal: southern Germany, Austria) => grüß Gott
good evening => guten Abend
good morning => guten Morgen
good afternoon / hello (formal) => guten Tag
hi (informal) => hallo
to shake hands => die Hand schütteln
take care (informal) => mach's gut
hello / good-bye (informal: southern Germany, Austria) => servus
bye (informal) => tschüss
have fun => viel Spaß
woman/wife => die Frau
female teacher => die Lehrerin
gentleman => der Herr
male teacher => der Lehrer
fellow (male) students => die Mitstudenten
fellow (female) students => die Mitstudentinnen
(female) friend => die Freundin
(female) professor => die Professorin
(female) student => die Studentin
(male) friend => der Freund
man => der Mann
(male) professor => der Professor
(male) student => der Student
blackboard/whiteboard => die Tafel
door => die Tür
pen => der Stift
pencil => der Bleistift
favorite color => die Lieblingsfarbe
favorite name => der Lieblingsname
CD => die CD
ball => der Ball
football => der Fußball
course => der Kurs
german course => der Deutschkurs
name => der Name
family name => der Familienname
first name => der Vorname
teddy bear => der Teddybär
car => das Auto
book => das Buch
to be called, be named => heißen
what's your name? (formal) => wie heißen Sie?
what's your name? (informal) => wie heißt du?
my name is => ich heiße 
what do your pictures show? => was zeigen Ihre Bilder?
what color is? => welche Farbe hat?
who? => wer?
how do you spell that? => wie schreibt man das?
how many? => wie viele?
where are you going? => wo willst du denn hin?
answer => die Antwort
introduction => die Einführung
question => die Frage
grammar => die Grammatik
homework => die Hausaufgabe
conversational situation => die Sprechsituation
exercise => die Übung
point => der Punkt
vocabulary => der Wortschatz
chapter => das Kapitel
ask questions => stellen Sie Fragen
sign here, please => unterschreib bitte hier
to connect => verbinden
but => aber
also / too / as well => auch
please => bitte
is there? / are there? => gibt es?
pretty => hübsch
broken => kaputt
my (male) => mein
my (female) => meine
with => mit
with the short hair => mit dem kurzen Haar
with the long hair => mit dem langen Haar
with dem Ohrring => mit the earring
with the mustache => mit dem Schnurrbart
no => nein
nicht => not
or => oder
dirty => schmutzig
to be => sein
but (rather / on the contrary) => sondern
do you like to wear? => trägst du gern?
a lot, much => viel
many => viele
of / from => von
to count => zählen
at home => zu Hause
old => alt
thanks => danke
then => dann
here => hier
in => in
new => neu
often => oft
so => so
and => und

ceiling => die Decke
ceilings => die Decken
blackboards/whiteboards => die Tafeln
clock => die Uhr
clocks => die Uhren
wall => die Wand
walls => die Wände
projector => der Beamer
projectors => die Beamer
floor => der Boden
floors => die Böden
laptop => der Laptop
laptops => die Laptops
pen => der Stift
pens => die Stifte
pencil => der Bleistift
pencils => die Bleistifte
table => der Tisch
tables => die Tische
window => das Fenster
windows => die Fenster
notebook => das Heft
notebooks => die Hefte
lamp => die Lampe
lamps => die Lampen
(female) professors => die Professorinnen
(female) students => die Studentinnen
university (short) => die Uni
universities (short) => die Unis
university (long) => die Universität
universities (long) => die Universitäten
(male) professors => die Professoren
(male) students => der Studenten
chair => der Stuhl
chairs => die Stühle
book => das Buch
books => die Bücher
paper => das Papier
a beard => einen Bart
blue eyes => blaue Augen
blond hair => blondes Haar
short hair => kurzes Haar
happy => glücklich
tall/big => groß
short/small => klein
quiet/calm => ruhig
clean => sauber
slender/slim => schlank
pretty/beautiful => schön
shy => schüchtern
sad => traurig
crazy => verrückt
blonde => blond
friendly => freundlich
young => jung
convervative => konservativ
long => lang
religious => religiös
athletic => sportlich
belly/stomach => der Bauch
bellies/stomachs => die Bäuche
head => der Kopf
heads => die Köpfe
mouth => der Mund
mouths => die Münder
back => der Rücken
backs => die Rücken
eye => das Auge
eyes => die Augen
leg => das Bein
legs => die Beine
face => das Gesicht
faces => die Gesichter
ear => das Ohr
ears => die Ohren
hand => die Hand
hands => die Hande
shoulder => die Schulter
shoulders => die Schultern
arm => der Arm
arms => die Arme
foot => der Fuß
feet => die Füße
hair => das Haar
hairs => die Haare
women/wives => die Frauen
niece => die Nichte
nieces => die Nichten
sister => die Schwester
sisters => die Schwestern
aunt => die Tante
aunts => die Tanten
man/husband => der Mann
men/husbands => die Männer
(male) cousin => der Vetter
(male) cousins => die Vettern
child => das Kind
children => die Kinder
parents => die Eltern
grandparents => die Großeltern
siblings => die Geschwister
(female) cousin => die Kusine
(female) cousins => die Kusinen
mother => die Mutter
mothers => die Mütter
grandmother => die Großmutter
grandmothers => die Größmutter
daughter => die Tochter
daughters => die Töchter
brother => der Bruder
brothers => die Brüder
nephew => der Neffe
nephews => die Neffen
uncle => der Onkel
uncles => die Onkel
son => der Sohn
sons => die Söhne
father => der Vater
fathers => die Väter
grandfather => der Großvater
grandfathers => die Größvater
spring => der Frühling
he spring => im Frühling
fall/autumn => der Herbst
month => der Monat
months => die Monate
year => das Jahr
years => die Jahre
it is 18 degrees Celsius => es ist 18 Grad Celsius
it is humid => es ist feucht
it is nice => es ist schön
it is raining / it rains => es regnet
it is snowing / it snows => es schneit
January => der Januar
in January => im Januar
February => der Februar
March => der März
April => der April
May => der Mai
June => der Juni
July => der Juli
August => der August
September => der September
Oktober => der Oktober
November => der November
December => der Dezember
Summer => der Sommer
Winter => der Winter
Fahrenheit => Fahrenheit
hot => heiß
cold => kalt
cool => kühl
sunny => sonnig
warm => warm
windy => windig
Germany => Deutschland
France => Frankreich
Greece => Griechenland
Austria => Österreich
Russia => Russland
Czech Republic => Tschechien
Hungary => Ungarn
capital city => die Hauptstadt
capital cities => die Häupstadte
Baltic Sea => die Ostsee
Switzerland => die Schweiz
Mediterranean Sea => das Mittelmeer
Africa => Afrika
America => Amerika
Asia => Asien
Australia => Australien 
Belgium => Belgien
Bulgaria => Bulgarien
China => China
Denmark => Dänemark
England => England
Europe => Europa
Finland => Finnland
Great Britain => Großbritannien
Holland => Holland
Ireland => Irland
Italy => Italien
Canada => Kanada
Liechtenstein => Liechtenstein
New Zealand => Neuseeland
North America => Nordamerika
Norway => Norwegen
Poland => Polen
Portugal => Portugal
Romania => Rumänien
Sweden => Schweden
Slovenia => Slowenien
Spain => Spanien
South America => Südamerika
North Sea => die Nordsee
Slovakia => die Slowakei
Turkey => die Türkei
Netherlands => die Niederlande
USA => die USA
German person => der Deutsche
German people => die Deutschen
I am German (male) => Ich bin Deutscher
I am German (female) => Ich bin Deutsche
French (male) => der Franzose
French (plural male) => die Franzosen
French (female) => die Französin
French (plural female) => die Französinnen
Austrian (male) => der Österreicher
Austrians (male) => die Österreicher
Austrian (female) => die Österreicherin
Austrians (female) => die Österreicherinnen
Swiss (male) => der Schweizer
Swiss (plural male) => die Schweizer
Swiss (female) => die Schweizerin
Swiss (plural female) => die Schweizerinnen
American (person) => die Amerikanerin
Americans => die Amerikanerinnen
Australian => die Australierin
Australians => die Australierinnen
English (person) => der Engländer
English (people) => die Engländer
Canadian (person) => der Kanadier
Canadian (people) => die Kanadier
Mexican (person) => der Mexikaner
Mexican (people) => die Mexikaner
German (language) => Deutsch
French (language) => Französisch
Arabic (language) => Arabisch
Chinese (language) => Chinesisch
English (language) => Englisch
Italian (language) => Italienisch
Portugese (language) => Portugiesisch
Russian (language) => Russisch
Swedish (language) => Schwedisch
Spanish (language) => Spanisch
Turkish (language) => Türkisch 
this/that is => das ist
these/those are => das sind
your (male/neuter object informal) => dein
your (female object informal) => deine
exactly => genau
today => heute
your (male/neuter object formal) => Ihr
your (female object formal) => Ihre
to know =>> kennen
to come from => kommen aus
unfortunately => leider
sometimes => manchmal
even/still => noch
very => sehr
to speak => sprechen
when => wann
what => was
// TODO: Figure out different cases for this word
which => welch
who => wer
how => wie
really => wirklich
where => wo
from where => woher
to live in => wohnen in
to chat => chatten
to read => lesen
he reads => er liest
she reads => sie liest
to read the newspaper => Zeitung lesen
to lie (down) => liegen
to lie in the sun => in der Sonne liegen
to travel => reisen
to write a text message => eine SMS schreiben
to sail => segeln
to text => simsen
to play => spielen
to hike => wandern
to camp => zelten
email => die E-Mail
emails => die E-Mails
guitar => die Gitarre
guitars => die Gitarren
map => die Karte
maps => die Karten
music => die Musik
sunglasses (single pair) => die Sonnenbrille
sunglasses (multiple pairs) => die Sonnenbrillen
balls => die Bälle
footballs => die Füßballe
coffee => der Kaffee
volleyball => der Volleyball
volleyballs => der Völleyballe
photo => das Foto
photos => das Fotos
golf => das Golf
hobby => das Hobby
hobbies => die Hobbys
chess => das Schach
snowboard => das Snowboard
snowboards => die Snowboards
tennis => das Tennis
boxing (sport) => boxen
to hear => hören
to cook => kochen
horse riding => reiten
swimming => schwimmen gehen
singing => singen
to surf the Internet => im Internet surfen
to dance => tanzen
work => die Arbeit
to go to work => zur Arbeit gehen
mountain => der Berg
mountains => die Berge
to go to the mountains => in die Berge gehen
to hike in the mountains => in den Bergen wandern
movie theater => das Kino
movie theaters => die Kinos
to go to the movies => ins Kino gehen
sea => das Meer
seas => die Meere
to swim in the sea => im Meer schwimmen
town hall => das Rathaus
town halls => die Räthauser
at the town hall => auf dem Rathaus
swimming pool => das Schwimmbad
swimming pools => die Schwimmbäder
to go to the swimming pool => ins Schwimmbad fahren
party => die Party
parties => die Partys
to go to a party => auf eine Party gehen
to go to the university => zur Uni gehen
to be at university => auf der uni sein
park => der Park
parks => die Parks
to walk in the park => im Park spazieren gehen
bed => das Bett
beds => die Betten
to go to bed => ins Bett gehen
house => das Haus
houses => die Häuser
at home => zu Hause sein
to go home => nach Hause gehen
concert => das Konzert
concerts => die Konzerte
to go to the concert => ins Konzert gehen
museum => das Museum
museums => die Museen
to go to the museum => ins Museum gehen
history => die Geschichte
art history => die Kunstgeschichte
computer science => die Informatik
art => die Kunst
test => die Prüfung
tests => die Prüfungen
school => die Schule
schools => die Schulen
(female) pupil => die Schülerin
(female) pupils => die Schülerinnen
social studies => die Sozialkunde
economics => die Wirtschaft
mechanical engineering => der Maschinenbau
(male) pupil => der Schüler
(male) pupils => die Schüler
schedule => der Stundenplan
schedules => die Stündenplane
center for study abroad => das Auslandsamt
centers for study abroad => die Aüslandsamter
academic subject => das Fach
academic subjects => die Fächer
scholarship => das Stipendium
scholarships => die Stipendien
university studies => das Studium
university studies (plural?) => die Studien
vacation (plural) => die Ferien
biology => die Biologie
chemistry => die Chemie
geography => die Geografie
linguistics => die Linguistik
literature => die Literatur
mathematics => die Mathematik
music => die Musik
break => die Pause
breaks => die Pausen
physics => die Physik
religion => die Religion
sociology => die Soziologie
courses => die Kurse
sport => der Sport
latin => das Latein
semester => das Semester
semesters => die Semester
to learn => lernen
to study => studieren
color => die Farbe
colors => die Farben
height => die Größe
heights => die Größen
scar => die Narbe
scars => die Narben
nationality/citizenship => die Staatsangehörigkeit
nationalities/citizenships => die Staatsangehörigkeiten
signature => die Unterschrift
signatures => die Unterschriften
profession => der Beruf
what's your profession? => was sind Sie von Beruf?
birthday => der Geburtstag
birthdays => die Geburtstage
(personal) ID card => der Personalausweis
(personal) ID cards => die Personalausweise
passport => der Reisepass
passports => die Rëisepasse
nickname => der Spitzname
nicknames => die Spitznamen
residence => der Wohnort
residences => die Wohnorte
age => das Alter
unmarried => ledig
married => verheiratet
address => die Adresse
addresses => die Addressen
eye color => die Augenfarbe
hair color => die Haarfarbe
number => die Nummer
numbers => die Nummern
house number => die Hausnummer
house numbers => die Hausnummern
telephone number => die Telefonnummer
telephone numbers => die Telefonnummern
person => die Person
people => die Personen
names => die Namen
family names => die Familiennamen
first names => die Vornamen
telephone => das Telefon
telephones => die Telefone
to be born => geboren
when were you born? => wann sind Sie geboren?
hour => die Stunde
hours => die Stunden
week => die Woche
weeks => die Wochen
during the week => in der Woche
evening => der Abend
evenings => die Abende
day => der Tag
days => die Tage
all day long => den ganzen Tag
Monday => der Montag
Tuesday => der Dienstag
Wednesday => der Mittwoch
Thursday => der Donnerstag
Friday => der Freitag
Saturday => der Samstag
Sunday => das Sonntag
weekend => das Wochenende
weekends => die Wochenenden
over the weekend => am Wochenende
early => früh
late => spät
later => später
at what time? => um wie viel Uhr?
when? => wann
at two thirty => um halb drei
at six o'clock => um sechs Uhr
at seven twenty => um sieben Uhr zwanzig
at a quarter to four => um Viertel vor vier
at twenty after/past five => um zwanzig nach fünf
what day is today => welcher Tag ist heute?
what time is it? (informal) => wie spät ist es?
what time is it? (formal) => wie viel Uhr ist es?
second => die Sekunde
seconds => die Sekunden
moment => der Moment
moments => die Momente
at the moment => im Moment
bag/purse/pocket => die Tasche
bags/purses/pockets => die Taschen
apartment => die Wohnung
apartments => die Wohnungen
letter => der Brief
letters => die Briefe
supper / evening meal => das Abendessen
suppers / evening meals => die Abendessen
bandanna => das Halstuch
bandannas => die Hälstucher
motorcycle => das Motorrad
motorcycles => die Mötorrader
to ride a motorcycle => Motorrad fahren
room => das Zimmer
rooms => die Zimmer
to pick (somebody) up (from a place) => abholen
to arrive => ankommen
to call up => anrufen
to stop (doing something) => aufhören
to clean (up) => aufräumen
to get up => aufstehen
to fill out => ausfüllen
to go out => ausgehen
to (go) shop(ping) => einkaufen
to pack up => einpacken
to watch TV => fernsehen
he is watching TV => er sieht fern
she is watching TV => sie sieht fern
to get acquainted with => kennenlernen
to work => arbeiten
to visit => besuchen
to need/use => brauchen
to (take a) shower => duschen
to fly => fliegen
to eat breakfast => frühstücken
to buy => kaufen
to like => mögen
I like => ich mag
you like => du magst
to go for a walk => spazieren gehen
to look for => suchen
to do => tun
to sign => unterschreiben
to begin => beginnen
to repair => reparieren
to drink => trinken
gladly / with pleasure => gern
we like to sing => wir singen gern
her (male/neuter object posessive) => ihr
her (female object posessive) => ihre
nervous => nervös
his (male/neuter object posessive) => sein
his (female object posessive) => seine
sure => sicher
probably => wahrscheinlich

TV set => der Fernseher
TV sets => die Fernseher
backpack => der Rucksack
backpacks => die Rücksacke
sleeping bag => der Schlafsack
sleeping bags => die Schläfsacke
jewelry => der Schmuck
desk => der Schreibtisch
desks => die Schreibtische
alarm clock => der Wecker
alarm clocks => die Wecker
picture => das Bild
pictures => die Bilder
boat => das Boot
boats => die Boote
bicycle => das Fahrrad
bicycles => die Fährrader
cellphone => das Handy
cellphones => die Handys
piano => das Klavier
pianos => die Klaviere
horse => das Pferd
horses => die Pferde
surfboard => das Surfbrett
surfboards => die Surfbretter
camera => die Kamera
cameras => die Kameras
cinema ticket => die Kinokarte
cinema tickets => die Kinokarten
CD player => der CD-Spieler
CD players => die CD-Spieler
computer => der Computer
computers => die Computer
DVD player => der DVD-Spieler
DVD players => die DVD-Spieler
I-Pod => der I-Pod
I-Pods => die I-Pods
MP3 player => der MP3-Spieler
MP3 players => die MP3-Spieler
hiking shoe => der Wanderschuh
hiking shoes => die Wanderschuhe
book => das Buch
books => die Bücher
songbook => das Songbuch
songbooks => die Songbücher
dictionary => das Wörterbuch
dictionaries => die Wörterbücher
radio => das Radio
radios => die Radios
telephone => das Telefon
telephones => die Telefone
video game => das Videospiel
video games => die Videospiele
wardrobe => das Schrank
wardrobes => die Schränke
armchair => der Sessel
armchairs => die Sessel
chair => der Stuhl
chairs => die Stühle
carpet => der Teppich
carpets => die Teppiche
bookshelf/bookcase => das Regal
bookshelfs/bookcases => die Regale
cat => die Katze
cats => die Katzen
dog => der Hund
dogs => die Hunde
house => das Haus
houses => die Häuser
necklace => die Halskette
necklaces => die Halsketten
sunglasses => die Sonnenbrille
sunglasses (plural) => die Sonnenbrillen
tights / sports pants => die Sporthose
tights / sports pants (plural) => die Sporthosen
underpants => die Unterhose
underpants (plural) => die Unterhosen
bathrobe => der Bademantel
bathrobes => die Bädemantel
belt => der Gürtel
belts => die Gürtel
glove => der Handschuh
gloves => die Handschuhe
bracelet => der Armband
bracelets => die Armbänder
nightshirt => das Nachthemd
nightshirts => die Nachthemden
undershirt => das Unterhemd
undershirts => die Unterhemden
jeans => die Jeans
sock => die Socke
socks => die Socken
sweater => der Pullover
sweaters => die Pullover
pullover => der Pulli
pullovers => die Pullis
ring => der Ring
rings => die Ringe
earring => der Ohrring
earrings => die Ohrringe
scarf => der Schal
scarves => die Schals
piercing => das Piercing
T-Shirt => das T-Shirt
T-Shirts => die T-Shirts
kind/type => die Art
kinds/types => die Arten
invitation => die Einladung
invitations => die Einladungen
student cafeteria => die Mensa
student cafeterias => die Mensen
female roommate/housemate => die Mitbewohnerin
female roommates/housemates => die Mitbewohnerinnen
order/sequence => die Reihenfolge
orders/sequences => die Reihenfolgen
thing => die Sache
things => die Sachen
city => die Stadt
cities => die Städte
cup => die Tasse
cups => die Tassen
telephone booth => die Telefonzelle
telephone booths => die Telefonzellen
newspaper => die Zeitung
newspapers => die Zeitungen
horror film => der Gruselfilm
horror films => die Gruselfilme
haircut => der Haarschnitt
haircuts => die Haarschnitte
person => der Mensch
people => die Menschen
Man! Oh boy! => Mensch!
male roommate/housemate => der Mitbewohner
male roommates/housemates => die Mitbewohner
forest/woods => der Wald
forests/woods (plural) => die Wälder
to run in the woods => im Wald laufen
breakfast => das Frühstuck
breakfasts => die Frühstucke
money => das Geld
store => das Geschäft
stores => die Geschäfte
present => das Geshcenk
presents => die Geshcenke
dorm => das Studentenheim
dorms => die Studentenheime
pleasure => das Vergnügen
tent => das Zelt
tents => die Zelte
relatives => die Verwandten
email => die E-Mail
emails => die E-Mails
birthday card => die Geburtstagskarte
birthday cards => die Geburtstagskarten
postcard => die Postkarte
postcards => die Postkarten
phone card => die Telefonkarte
phone cards => die Telefonkarten
party => die Party
parties => die Partys
pizza => die Pizza
pizzas => die Pizzen
basketball => der Basketball
basketballs => die Bäsketballe
bus => der Bus
busses => die Busse
film => der Film
films => die Filme
flea market => der Flohmarkt
flea markets => die Flöhmarkte
kilometer => der Kilometer
kilometers => die Kilometer
beer => das Bier
beers => die Biere
thing => das Ding
thing => die Dinge
ice => das Eis
hotel => das Hotel
hotels => die Hotels
restaurant => das Restaurant
restaurants => die Restaurants
to look at => anschauen
to look => aussehen
it looks good => es sieht gut aus
to invite => einladen
to eat => essen
to drive => fahren
to believe => glauben
to ring => klingeln
laufen => to run
would like => möchten
to be right => recht haben
to send => schicken
to sleep => schlafen
to do sports => Sport treiben
to stand => stehen
That looks good on you! => Das steht dir gut!
Those look good on you! => Die stehen dir gut!
to meet => treffen
Let's meet. => Treffen wir uns.
to sell => verkaufen
to know => wissen
to move => ziehen
to bring => bringen
to find => finden
to cost => kosten
to see => sehen
to forget => vergessen
to wash => waschen
cheap/inexpensiv => billig
large/fat => dick
urgent(ly) => dringend
real(ly) => echt
simple/simply => einfach
wrong => falsch
whole; here: quite => ganz
gaudy, shrill; here: cool, neat => grell
ugly => hässlich
boring => langweilig
right/correct => richtig
bad => schlecht
difficult => schwierig
sweet => süß
totally sweet => voll süß
expensive => teuer
neat/great => toll
valuable/expensive => wertvoll
important => wichtig
rather => ziemlich
pretty big => ziemlich groß
too => zu
better => besser
fancy => schick
your (male, informal, singular) => deinen
your (neuter, informal, singular) => dein
your (female, informal, singular) => deine
your (male, informal, plural) => euren
your (neuter, informal, plural) => euer
your (female, informal, plural) => eure
her (possessive) => ihr
its (possessive) => ihre
their (possessive) => ihren
your (male, formal) => Ihren
your (neuter, formal) => Ihr
your (female, formal) => Ihre
my (male) => meinen
my (neuter) => mein
my (female) => meine
his/its (male) => seinen
his/its (neuter) => sein
his/its (female) => seine
our (male) => unseren
our (neuter) => unser
our (female) => unsere
at/on/to => an
on Saturday => am Samstag
on the phone => am Telefon
to the sea => ans Meer
with/at => bei
at Monika's => bei Monika
until => bis
until eight o'clock => bis acht Uhr
for => für
to/for (an occasion) => zu
for someone's birthday => zum Geburtstag
to the university => zur Uni
everything => alles
everything possible => alles Mögliche
there => da
you (accusative) => dich
this => diese
these => diesen
a few => ein paar
something => etwas
this evening => heute Abend
him/it (accusative) => ihn
no/none (male) => keinen
no/none (neuter) => kein
no/none (female) => keine
Of course! => Klar!
rather => lieber
at noon => mittags
tomorrow => morgen
naturally => natürlich
never => nie
no one / nobody => niemand
per => pro
already => schon
perhaps => vielleicht
if/when => wenn
together => zusammen

visit => der Besuch
visits => die Besuche
to visit => zu Besuch kommen
ice skate => der Schlittschuh
ice skates => die Schlittschuhe
to go ice-skating => Schlittschuh laufen
joke => der Witz
jokes => die Witze
to tell jokes => Witze erzählen
to cut => schneiden
to cut hair => Haare schneiden
to knit => stricken
to dive => tauchen
to type => tippen
to draw => zeichnen
ski => der Ski
skis => die Skier
to go skiing => Ski fahren
Waltz => der Walzer
Waltzes => die Walzer
skateboard => der Skateboard
skateboards => die Skateboards
to go skateboarding => Skateboard fahren
to clear => abräumen
to clear the table => den Tisch abräumen
to straighten => gerade stellen
to water => gießen
to water the flowers => die Blumen gießen
to clean => sauber machen
fear => die Angst
fears => die Ängste
to be afraid => Angst haben
hurry => die Eile
to be in a hurry => in Eile sein
boredom => die Langeweile
to be bored => Langeweile haben
desire => die Lust
to feel like (doing something) => Lust haben
luck/happiness => das Glück
lots of luck! good luck! => viel Glück!
homesickness => das Heimweh
to be homesick => Heimweh haben
to annoy/tease => ärgern
to scream/yell => schreien
to disturb => stören
to cry => weinen
jealous => eifersüchtig
sick => krank
nice => nett
tired => müde
angry => wütend
thirst => der Durst
to be thirsty => Durst haben
hunger => der Hunger
to be hungry => Hunger haben
feeling => das Gefühl
feelings => die Gefühle
to feel => fühlen
How do you feel? => Wie fühlst du dich?
tutoring => die Nachhilfe
office hour => die Sprechstunde
office hours => die Sprechstunden
sentence => der Satz
sentences => die Sätze
workbook => das Arbeitsbuch
workbooks => die Arbeitsbücher
example => das Beispiel
examples => die Beispiele
for example => zum Beispiel
report => das Referat
reports => die Referate
female physician => die Ärztin
female physicians => die Ärztinnen
flower => die Blume
flowers => die Blumen
violin => die Geige
violins => die Geigen
beloved female friend => die Geliebte
beloved female friends => die Geliebten
candle => die Kerze
candles => die Kerzen
grandma => die Oma
grandmas => die Omas
duty/requirement => die Pflicht
duties/requirements => die Pflichten
male physician => der Arzt
male physicians => die Ärzte
wastebasket => der Papierkorb
wastebaskets => die Papïerkorbe
poem => das Gedicht
poems => die Gedichte
hospital => das Krankenhaus
hospitals => die Krankenhäuser
lunch => das Mittagessen
handkerchief => das Taschentuch
handkerchiefs => die Taschentücher
animal => das Tier
animals => die Tiere
disco => die Disko
discos => die Diskos
company => die Firma
companies => die Firmen
night => die Nacht
nights => die Nächte
plant => die Pflanze
plants => die Pflanzen
noon => der Mittag
noons => die Mittage
plan => der Plan
plans => die Pläne
space => der Platz
spaces => die Plätze
alphabet => das Alphabet
light => das Licht
lights => die Lichter
talent => das Talent
talents => die Talente
taxi => das Taxi
taxis => das Taxis
table tennis => das Tischtennis
to be permitted (to) => dürfen
to be able (to) => können
to like / care for => mögen
to have to => müssen
to be supposed to => sollen
to want/intend/plan (to) => wollen
to turn/switch on => anmachen
to look at / watch => ansehen
to put on (clothes) => anziehen
to light => anzünden
to open => aufmachen
to pay attention => aufpassen
to empty => ausleeren
to turn off => ausmachen
to take off (clothes) => ausziehen
to get/receive => bekommen
to remain/stay => bleiben
to experience => erleben
to tell => erzählen
to marry => heiraten
to love => lieben
to take along => mitnehmen
to try/taste => probieren
to smoke => rauchen
to put/place (upright) => stellen
to spend (stime) => verbringen
to go on a trip => verreisen
to come by / visit => vorbeikommen
to throw => werfen
to close => zumachen
to bathe => baden
to hang => hängen
to hope => hoffen
to comb => kämmen
to combine => kombinieren
to laugh => lachen
to live => leben
to bring => mitbringen
the picture hanging on the wall => das Bild an die Wand hängen
excellent => ausgezeichnet
popular => beliebt
particularly => besonders
definitely/certainly => bestimmt
actually => eigentlich
ready/finished => fertig
enough => genug
wet => nass
heavy/hard/difficult => schwer
true => wahr
besides => außerdem
to take the day off => blau machen
three times => dreimal
one another / each other => einander
in a row => hintereinander
with each other => miteinander
a little bit => ein bisschen
Excuse me! => Entschuldigung!
all night long => die ganze Nacht
quite a bit => ganz schön viel
not a bit => gar nicht
always => immer
each/every => jede
every week => jede Woche
someone/somebody => jemand
now => jetzt
not at all => kein bisschen
with me => mit mir
well => na
after/to => nach
beside / in addition to => neben
only => nur
certainly => sicherlich
immediately => sofort
from work => von der Arbeit
why => warum
because => weil
again => wieder
once again => schon wieder
where to => wohin
on foot => zu Fuß
to the doctor => zum Arzt
for lunch => zum Mittagessen

ticket => die Fahrkarte
tickets => die Fahrkarten
train station => der Bahnhof
train stations => die Bahnhöfe
driver's license => der Führerschein
driver's licenses => die Führerscheine
sleeping car => der Schlafwagen
sleeping cars => die Schlafwagen
accident => der Unfall
accidents => die Unfälle
vacation => der Urlaub
vacations => die Urlaube
in the evening => am Abend
daily routine => der Alltag
afternoon => der Nachmittag
afternoons => die Nachmittage
late morning => der Vormittag
late mornings => die Vormittage
date => das Datum
dates => die Daten
what is today's date? => welches Datum ist heute?
time => das Mal
times => die Male
the last time => das letzte Mal
for the first time => zum ersten Mal
evenings / in the evening => abends
yesterday => gestern
last night => gestern Abend
last week => letzte Woche
last Monday => letzten Montag
last summer => letzten Sommer
last weekend => letztes Wochenende
afternoons / in the afternoon => nachmittags
nights / at night => nachts
the day before yesterday => vorgestern
on the first of October => am ersten Oktober
on what day? => an welchem Tag?
until four o'clock => bis um vier Uhr
once => einmal
were you ever ...? => warst du schon einmal ...?
not until => erst
not until four o'clock => erst um vier Uhr
until four in the morning => bis um vier Uhr früh
since / for => seit
for two years => seit zwei Jahren
over => über
over the weekend => übers Wochenende
ago => vor
two days ago => vor zwei Tagen
assignment => die Aufgabe
assignments => die Aufgaben
library => die Bibliothek
libraries => die Bibliotheken
lecture => die Vorlesung
lectures => die Vorlesungen
ballpoint pen => der Kugelschreiber
ballpoint pens => die Kugelschreiber
high school graduation exam => das Abitur
to take (a course) => belegen
to hold => halten
to give (a paper / oral report) => ein Referat halten
holiday => der Feiertag
holidays => die Feiertage
national holiday => der Nationalfeiertag
national holidays => die Nationalfeiertage
family celebration => das Familienfest
family celebrations => die Familienfeste
Christmas => das Weihnachten
tradition => das Tradition
traditions => die Traditionen
mother's day => der Muttertag
valentine's day => der Valentinstag
picnic => das Picknick
picnics => die Picknicks
first => erste
the first of October => der erste Oktober
second => zweite
third => dritte
fourth => vierte
fifth => fünfte
sixth => sechste
seventh => siebte
eighth => achte
ninth => neunte
tenth => zehnte
eleventh => elfte
twelfth => zwölfte
thirteenth => dreizehnte
twentieth => zwanzigste
hundredth => hundertste
memory/remembrance => die Erinnerung
memories/remembrances => die Erinnerungen
bar/tavern => die Kneipe
bars/taverns => die Kneipen
female neighbor => die Nachbarin
female neighbors => die Nachbarinnen
bill/check (in restaurant) => die Rechnung
bills/checks (in restaurant) => die Rechnungen
sandcastle => die Sandburg
sandcastles => die Sandburgen
survey => die Umfrage
surveys => die Umfragen
university newspaper => die Unizeitung
university newspapers => die Unizeitungen
basement/cellar => der Keller
basements/cellars => die Keller
kiss => der Kuss
kisses => die Küsse
deck chair => der Liegestuhl
deck chairs => die Liegestühle
male neighbor => der Nachbar
male neighbors => die Nachbarn
beach => der Strand
beaches => die Strände
vacation house => das Ferienhaus
vacation houses => die Ferienhäuser
dishes => das Geschirr
to wash the dishes => Geschirr spülen
decade => das Jahrzehnt
decades => die Jahrzehnte
language laboratory => das Sprachlabor
language laboratories => die Sprachlabors
diary => das Tagebuch
diaries => die Tagebücher
information => das Information
informations => die Informationen
reporter (female) => die Reporterin
reporters (female) => die Reporterinnen
role => Rolle
roles => Rollen
laundry => die Wäsche
cigarette => die Zigarette
cigarettes => die Zigaretten
coffee filter => der Kaffeefilter
coffee filters => die Kaffeefilter
reporter (male) => der Reporter
reporters (male) => die Reporter
tea => der Tee
Uranus => der Uranus
accordion => das Akkordeon
accordions => die Akkordeons
cafe => das Café
cafes => die Cafés
interview => das Interview
interviews => die Interviews
penicillin => das Penizillin
percent => das Prozent
percentages => die Prozente
student life => das Studentenleben
theater => das Theater
theaters => die Theater
topic => das Thema
topics => die Themen
toilet paper => das Toilettenpapier
wonder => das Wunder
wonders => die Wunder
no wonder => kein Wunder
to depart => abfahren
to begin => anfangen
to answer => antworten
to wake up => aufwachen
to pay (for) => bezahlen
to last => dauern
to think (of) => denken
to discover => entdecken
to decide => entschieden | entscheiden
to invent => erfinden | erfunden
to complete / fill in the blanks => ergänzen
to celebrate => feiern
to drive off => losfahren
to happen => passieren
to wash/rinse => spülen
to earn => verdienen
to understand => verstehen | verstanden
to try/attempt => versuchen
was/were => was | warst | waren
to discuss => diskutieren
to have dinner => zu Abend essen
to photograph => fotografieren
to win => gewinnen
to correct => korrigieren
to sit => sitzen
to phone => telefonieren
to go away => weggehen
terrible => furchtbar
just/barely => knapp
lefft => links
to get up on the wrong side of bed => mit dem linken Fuß aufstehen
punctual / on time => pünktlich
in love => verliebt
total => total
well/so/thus => also
by all means => auf jeden Fall
that sounds great => das hört sich toll an
therefore / that's why => deshalb
yes (on the contrary)! => doch!
something interesting => etwas Interessantes
something new => etwas Neues
in the garden => im Garten
at the cafe => im Café
indeed => ja
that's just it! => das ist es ja!
I'm sorry => tut mir leid
whom (accusative) => wen
first => zuerst


